1111111111111111111111111111111111111
1C00000000000000000000000000000000001
1000000000000000000000000000000000001
1000000000000000000000000000000000001
100000000E000000000000000000000000001
1000000000000C000C00000C0000000000001
10000000000000000000C0000C00000000001
10000000000000000CC000CC000000000C001
1001C000000000C00C00CC0C00C0000000001
1000000000000000000000000000000000001
1000000C00000000C00000C0000C000000001
10000000001P00CCCCCCCCCC0000000000001
10000000000100000000010011C00C0000001
1000000000000000000000000000000000001
100000C0000000000000C0000000000000011
1000000000000000000000000000000000001
1111111111111111111111111111111111111