1111111111111111111
1C00000000C00000001
1000111100000000001
1000000111000000001
1000000C1C00C000001
10000C1010101100001
1000000000000C00001
100000000C000110001
11110C000P000010011
10C1000000000010001
10000000000C00000E1
1111111111111111111