1111111111111
1C110010000C1
101001E100001
1P00000001001
1111111111111